Uab - действующее значение напряжения  первой гармоники между фазами A, B
Ubc - действующее значение напряжения  первой гармоники между фазами B, C
Uca - действующее значение напряжения  первой гармоники между фазами C, A
Iab - действующее значение тока первой гармоники между фазами A, B
Ibc - действующее значение тока первой гармоники между фазами B, C
Ica - действующее значение тока первой гармоники между фазами C, A
Ia - действующее значение тока первой гармоники фазы A
Ib - действующее значение тока первой гармоники фазы B
Ic - действующее значение тока первой гармоники фазы C
Ua - действующее значение напряжения первой гармоники фазы A
Ub - действующее значение напряжения первой гармоники фазы B
Uc - действующее значение напряжения первой гармоники фазы C
Pп - активная электрическая мощность прямой последовательности
Pо - активная электрическая мощность обратной последовательности
Pн - активная электрическая мощность нулевой последовательности
Qп - реактивная электрическая мощность прямой последовательности
Qо - реактивная электрическая мощность обратной последовательности
Qн - реактивная электрическая мощность нулевой последовательности
Sп - полная электрическая мощность прямой последовательности
Sо - полная электрическая мощность обратной  последовательности
Sн - полная электрическая мощность нулевой последовательности
Uп - значение напряжения переменного тока прямой последовательности
Uо - значение напряжения переменного тока обратной последовательности
Uн - значение напряжения переменного тока нулевой последовательности
Iп - значение силы переменного тока прямой последовательности
Iо - значение силы переменного тока обратной последовательности
Iн - значение силы переменного тока нулевой последовательности
Kо - коэффициент несимметрии напряжения по обратной последовательности
Kн - коэффициент несимметрии напряжения по нулевой последовательности
∆f, Гц - отклонение частоты
∆Uy - установившееся отклонение напряжения прямой последовательности
∆UyAB - установившееся отклонение напряжения между фазами A, B
∆UyBC - установившееся отклонение напряжения между фазами B, C
∆UyCA - установившееся отклонение напряжения между фазами C, A
∆UyA - установившееся отклонение напряжения фазы A
∆UyB - установившееся отклонение напряжения фазы B
∆UyC - установившееся отклонение напряжения фазы C
схема проверки 1 = 1-ф 2-пр
схема проверки 2 = 3-ф 3-пр
схема проверки 3 = 3-ф 4-пр
